#FUNCTIONS COLOR 			#D35400 - ORANGE			KEYWORD1
#FUNCTIONS COLOR			#D35400 - ORANGE			KEYWORD2
#STRUCTURE COLORS 		#728E00 - GREEN				KEYWORD3
#VARIABLES COLOR 			#00979C - BLUE				LITERAL1
EasyKids3in1    KEYWORD1
# LITERAL1 specifies constants

BLACK	LITERAL1	Constants	RESERVED_WORD_2
WHITE	LITERAL1	Constants	RESERVED_WORD_2
RED	LITERAL1	Constants	RESERVED_WORD_2
GREEN	LITERAL1	Constants	RESERVED_WORD_2
BLUE	LITERAL1	Constants	RESERVED_WORD_2
YELLOW	LITERAL1	Constants	RESERVED_WORD_2
MAGENTA	LITERAL1	Constants	RESERVED_WORD_2
CYAN	LITERAL1	Constants	RESERVED_WORD_2
ORANGE	LITERAL1	Constants	RESERVED_WORD_2
PINK	LITERAL1	Constants	RESERVED_WORD_2
NAVY	LITERAL1	Constants	RESERVED_WORD_2
DARKGREEN	LITERAL1	Constants	RESERVED_WORD_2
DARKCYAN	LITERAL1	Constants	RESERVED_WORD_2
MAROON	LITERAL1	Constants	RESERVED_WORD_2
PURPLE	LITERAL1	Constants	RESERVED_WORD_2
OLIVE	LITERAL1	Constants	RESERVED_WORD_2
LIGHTGREY	LITERAL1	Constants	RESERVED_WORD_2
DARKGREY	LITERAL1	Constants	RESERVED_WORD_2
TFT_BLACK	LITERAL1	Constants	RESERVED_WORD_2
TFT_NAVY	LITERAL1	Constants	RESERVED_WORD_2
TFT_DARKGREEN	LITERAL1	Constants	RESERVED_WORD_2
TFT_DARKCYAN	LITERAL1	Constants	RESERVED_WORD_2
TFT_MAROON	LITERAL1	Constants	RESERVED_WORD_2
TFT_PURPLE	LITERAL1	Constants	RESERVED_WORD_2
TFT_OLIVE	LITERAL1	Constants	RESERVED_WORD_2
TFT_LIGHTGREY	LITERAL1	Constants	RESERVED_WORD_2
TFT_DARKGREY	LITERAL1	Constants	RESERVED_WORD_2
TFT_BLUE	LITERAL1	Constants	RESERVED_WORD_2
TFT_GREEN	LITERAL1	Constants	RESERVED_WORD_2
TFT_CYAN	LITERAL1	Constants	RESERVED_WORD_2
TFT_RED	LITERAL1	Constants	RESERVED_WORD_2
TFT_MAGENTA	LITERAL1	Constants	RESERVED_WORD_2
TFT_YELLOW	LITERAL1	Constants	RESERVED_WORD_2
TFT_WHITE	LITERAL1	Constants	RESERVED_WORD_2
TFT_ORANGE	LITERAL1	Constants	RESERVED_WORD_2
TFT_GREENYELLOW	LITERAL1	Constants	RESERVED_WORD_2
TFT_PINK	LITERAL1	Constants	RESERVED_WORD_2
Sarabun08EN	LITERAL1	Constants	RESERVED_WORD_2
Sarabun08TH	LITERAL1	Constants	RESERVED_WORD_2
Sarabun09EN	LITERAL1	Constants	RESERVED_WORD_2
Sarabun09TH	LITERAL1	Constants	RESERVED_WORD_2
Sarabun10EN	LITERAL1	Constants	RESERVED_WORD_2
Sarabun10TH	LITERAL1	Constants	RESERVED_WORD_2
Sarabun12EN	LITERAL1	Constants	RESERVED_WORD_2
Sarabun12TH	LITERAL1	Constants	RESERVED_WORD_2
Sarabun14EN	LITERAL1	Constants	RESERVED_WORD_2
Sarabun14TH	LITERAL1	Constants	RESERVED_WORD_2
Sarabun16EN	LITERAL1	Constants	RESERVED_WORD_2
Sarabun16TH	LITERAL1	Constants	RESERVED_WORD_2
Sarabun18EN	LITERAL1	Constants	RESERVED_WORD_2
Sarabun18TH	LITERAL1	Constants	RESERVED_WORD_2
SarabunBold8EN	LITERAL1	Constants	RESERVED_WORD_2
SarabunBold8TH	LITERAL1	Constants	RESERVED_WORD_2
SarabunBold9EN	LITERAL1	Constants	RESERVED_WORD_2
SarabunBold9TH	LITERAL1	Constants	RESERVED_WORD_2
SarabunBold10EN	LITERAL1	Constants	RESERVED_WORD_2
SarabunBold10TH	LITERAL1	Constants	RESERVED_WORD_2
SarabunBold12EN	LITERAL1	Constants	RESERVED_WORD_2
SarabunBold12TH	LITERAL1	Constants	RESERVED_WORD_2
SarabunBold14EN	LITERAL1	Constants	RESERVED_WORD_2
SarabunBold14TH	LITERAL1	Constants	RESERVED_WORD_2
SarabunBold16EN	LITERAL1	Constants	RESERVED_WORD_2
SarabunBold16TH	LITERAL1	Constants	RESERVED_WORD_2
SarabunBold18EN	LITERAL1	Constants	RESERVED_WORD_2
SarabunBold18TH	LITERAL1	Constants	RESERVED_WORD_2
Kanit09EN	LITERAL1	Constants	RESERVED_WORD_2
Kanit09TH	LITERAL1	Constants	RESERVED_WORD_2
Kanit12EN	LITERAL1	Constants	RESERVED_WORD_2
Kanit12TH	LITERAL1	Constants	RESERVED_WORD_2
Kanit18EN	LITERAL1	Constants	RESERVED_WORD_2
Kanit18TH	LITERAL1	Constants	RESERVED_WORD_2
Kanit24EN	LITERAL1	Constants	RESERVED_WORD_2
Kanit24TH	LITERAL1	Constants	RESERVED_WORD_2
KanitBold9EN	LITERAL1	Constants	RESERVED_WORD_2
KanitBold9TH	LITERAL1	Constants	RESERVED_WORD_2
KanitBold12EN	LITERAL1	Constants	RESERVED_WORD_2
KanitBold12TH	LITERAL1	Constants	RESERVED_WORD_2
KanitBold18EN	LITERAL1	Constants	RESERVED_WORD_2
KanitBold18TH	LITERAL1	Constants	RESERVED_WORD_2
KanitBold24EN	LITERAL1	Constants	RESERVED_WORD_2
KanitBold24TH	LITERAL1	Constants	RESERVED_WORD_2

# KEYWORD2 specifies methods and functions

servoSpeed	KEYWORD2	Abs
Vbattery	KEYWORD2	ACos
batteryPercent	KEYWORD2
welcomeSong	KEYWORD2	ASin
marioSong	KEYWORD2
pacmanSong	KEYWORD2	ATan
happyBirthDaySong	KEYWORD2	ATan2
beep	KEYWORD2
analog	KEYWORD2
digitalOut	KEYWORD2
digitalIn	KEYWORD2
digitalIn_Pullup	KEYWORD2	Ceil
displayClear	KEYWORD2
display3in1	KEYWORD2	Constrain
motor	KEYWORD2
motorStopAll	KEYWORD2
servo	KEYWORD2	Cos
ledSetBrightness	KEYWORD2
ledCarSetBrightness	KEYWORD2
ledCarSetColorRGB	KEYWORD2
ledCarSetColor	KEYWORD2
ledFillRGB	KEYWORD2	Exp
ledCarFillRGB	KEYWORD2
ledFillColor	KEYWORD2
ledCarFillColor	KEYWORD2
rainbow	KEYWORD2
rainbowCar	KEYWORD2
colorWipe	KEYWORD2
colorWipeCar	KEYWORD2
theaterChaseRainbow	KEYWORD2	Floor
theaterChaseRainbowCar	KEYWORD2
rainbowAll	KEYWORD2
theaterChaseRainbowAll	KEYWORD2
JoyController_Setup	KEYWORD2
showAddressLcd	KEYWORD2
joyLX   KEYWORD2
joyLY   KEYWORD2
joyRX   KEYWORD2
joyRY   KEYWORD2
joyCross    KEYWORD2
joyCircle   KEYWORD2
joySquare   KEYWORD2
joyTriangle KEYWORD2
joyL1   KEYWORD2
joyL2   KEYWORD2
joyR1   KEYWORD2
joyR2   KEYWORD2
joyUp   KEYWORD2
joyDown KEYWORD2
joyLeft KEYWORD2
joyRight    KEYWORD2
sonar	KEYWORD2	Map
waitForStart	KEYWORD2	Max
sw_Start	KEYWORD2	Min
testServo	KEYWORD2	Pow
vr	KEYWORD2
EasyKids_Setup	KEYWORD2

# KEYWORD3 specifies structures

break	KEYWORD3	Break	RESERVED_WORD
case	KEYWORD3	SwitchCase	RESERVED_WORD
override	KEYWORD3		RESERVED_WORD
final	KEYWORD3		RESERVED_WORD
continue	KEYWORD3	Continue	RESERVED_WORD
default	KEYWORD3	SwitchCase	RESERVED_WORD
do	KEYWORD3	DoWhile	RESERVED_WORD
else	KEYWORD3	Else	RESERVED_WORD
for	KEYWORD3	For	RESERVED_WORD
if	KEYWORD3	If	RESERVED_WORD
return	KEYWORD3	Return	RESERVED_WORD
goto	KEYWORD3		RESERVED_WORD
	
switch	KEYWORD3	SwitchCase	RESERVED_WORD
throw	KEYWORD3		RESERVED_WORD
try	KEYWORD3		RESERVED_WORD
while	KEYWORD3	While	RESERVED_WORD

setup	KEYWORD3	Setup	RESERVED_WORD
loop	KEYWORD3	Loop	RESERVED_WORD
export	KEYWORD3		RESERVED_WORD

not	KEYWORD3	If	RESERVED_WORD
or	KEYWORD3	If	RESERVED_WORD
and	KEYWORD3	If	RESERVED_WORD
xor	KEYWORD3	If	RESERVED_WORD

# operators aren't highlighted, but may have documentation

+=		IncrementCompound
+		Arithmetic
[]		arrayaccess
=		assign
&		BitwiseAnd
|		BitwiseAnd
^		BitwiseAnd
~		BitwiseXorNot
,
//		Comments
?:
{}		Braces
--		Increment
/		Arithmetic
/*		Comments
.		dot
==		If
<		If
<=		If
++		Increment
!=		If
<<		Bitshift
>		If
>=		If
&&		Boolean
!		Boolean
||		Boolean
-		Arithmetic
%		Modulo
*		Arithmetic
()		parentheses
>>		Bitshift
;		SemiColon
-=		DecrementCompound

\#include	KEYWORD3		PREPROCESSOR
\#define	KEYWORD3		PREPROCESSOR
\#elif	KEYWORD3		PREPROCESSOR
\#else	KEYWORD3		PREPROCESSOR
\#error	KEYWORD3		PREPROCESSOR
\#if	KEYWORD3		PREPROCESSOR
\#ifdef	KEYWORD3		PREPROCESSOR
\#ifndef	KEYWORD3		PREPROCESSOR
\#pragma	KEYWORD3		PREPROCESSOR
\#warning	KEYWORD3		PREPROCESSOR
